31 15;
###################.###########
#          .       .          #
#  .  .            .          #
#                  .          #
#       .          &   .      #
#  O   C     O     .          #
#       .          .    O     #
#      O           .   OOO    #
#  &               .    O     #
          &        .
#                  .    &     #
#    .             ..         #
#        .    O   ..     O    #
#                  .          #
###################.###########
