30 5;
##############################
#&   .    &     .   O     C  #
##  ############.#############
#&   .    &     .            #
##############################
