41 15;
###########################.#############
#    .                     .            #
#                          .            #
#             .            .            #
#                          &   .        #
#  O     C           O     .            #
#               .          .            #
#        O                 .            #
#  &                       .            #
                  &        .             
#              .           .    &       #
#      .                   ..           #
#             .       O   ..       O    #
#                          .            #
###########################.#############
