21 21;
 ################### 
 #........#........# 
 #O##.###.#.###.##O# 
 #.................# 
 #.##.#.#####.#.##.# 
 #....#...#...#....# 
 ####.### # ###.#### 
    #.#       #.#    
#####.# ##&## #.#####
     .  #&&&#  .     
#####.# ##### #.#####
    #.#       #.#    
 ####.# ##### #.#### 
 #........#........# 
 #.##.###.#.###.##.# 
 #O.#.....C.....#.O# 
 ##.#.#.#####.#.#.## 
 #....#...#...#....# 
 #.######.#.######.# 
 #.................# 
 ################### 
